##################################################
#                                                #
#                                                #
#                                                #
###########                                      #
##     M  #                                      #
##        #                                      #
##   M    #                                      #
##P       #                                      #
##        #                                      #
##        #                                      #
##        #                                      #
##   M    #                                      #
###########                                      #
#                                                #
#                                                #
#                                                #
#                                                #
#                                                #
#                                                #
#                                                #
#                                                #
#                                                #
#                                                #
#                                                #
#                                                #
#                                                #
#                                                #
#                                                #
##################################################
